(supertux-level
  (version 2)
  (name (_ "Press ACTION at the InfoBlock"))
  (author "manuel")
  (license "GPL 2+ / CC-by-sa 3.0")
  (target-time 0)
  (sector
    (name "main")
    (init-script "Text.set_anchor_point(ANCHOR_TOP)
Text.set_text(\"For your own safety:\\nQuit the level only at the snow part.\")
Text.fade_in(0.2)")
    (ambient-light 1 1 1)
    (camera
      (mode "normal")
    )
    (climbable
      (width 864.0007)
      (height 640.0002)
      (x 96)
      (y 96)
    )
    (decal
      (x 96)
      (y 96)
      (layer -50)
      (sprite "images/background/bonuslevel-search.png")
    )
    (scripttrigger
      (script "Text.set_text(\"Now find the Paper Boat\")
found1 <- true")
      (button #t)
      (width 32)
      (height 32)
      (x 190.2196)
      (y 373.4112)
    )
    (scripttrigger
      (script "found_block(\"waldo\")")
      (button #f)
      (width 80)
      (height 69)
      (x 871)
      (y 602)
    )
    (scripttrigger
      (script "if(\"found1\" in this){
Text.set_text(\"Now find the Coconut\")
found2 <- true
}")
      (button #t)
      (width 38.36401)
      (height 25.28253)
      (x 626.5045)
      (y 673.2245)
    )
    (scripttrigger
      (script "if(\"found2\" in this){
Text.set_text(\"Now find the Fez\")
found3 <- true
}")
      (button #t)
      (width 26.34308)
      (height 41.54599)
      (x 933.0471)
      (y 156.4198)
    )
    (scripttrigger
      (script "if(\"found3\" in this){
Text.set_text(\"Now find the Zeekling\")
found4 <- true
}")
      (button #t)
      (width 26.34308)
      (height 32.00009)
      (x 325.4615)
      (y 346.9746)
    )
    (scripttrigger
      (script "if(\"found4\" in this){
Text.set_text(\"Now find the Coin\")
found5 <- true
}")
      (button #t)
      (width 55.68811)
      (height 37.30325)
      (x 770.3037)
      (y 348.5352)
    )
    (scripttrigger
      (script "if(\"found5\" in this){
Text.set_text(\"Now find the Air Hat\")
found6 <- true
}")
      (button #t)
      (width 22.68811)
      (height 26.80322)
      (x 443.2474)
      (y 576.8343)
    )
    (scripttrigger
      (script "if(\"found6\" in this){
Text.set_text(\"Now press the button\")
found7 <- true
Tux.add_bonus(\"airflower\")
}")
      (button #t)
      (width 102.1881)
      (height 47.80322)
      (x 634.2646)
      (y 122.8699)
    )
    (scripttrigger
      (script "if(\"found7\" in this){
got_achievement(\"waldo\")
}")
      (button #f)
      (width 336.056)
      (height 121.0955)
      (x 362.0207)
      (y 747.3362)
    )
    (spawnpoint
      (name "main")
      (x 128)
      (y 800)
    )
    (switch
      (script "if(\"found7\" in this){
Text.set_anchor_point(ANCHOR_MIDDLE)
Text.fade_out(0.05)
sector.Tux.trigger_sequence(\"fireworks\")
}")
      (sprite "images/objects/switch/switch.sprite")
      (x 515)
      (y 772)
    )
    (tilemap
      (solid #t)
      (z-pos 0)
      (name "Interactive")
      (width 33)
      (height 30)
      (tiles
      48 48 48 48 48 48 48 48 48 48 48 48 48 48 48 48 48 48 48 48 48 48 48 48 48 48 48 48 48 48 48 48 48
      48 48 48 48 48 48 48 48 48 48 48 48 48 48 48 48 48 48 48 48 48 48 48 48 48 48 48 48 48 48 48 48 48
      48 48 48 48 48 48 48 48 48 48 48 48 48 48 48 48 48 48 48 48 48 48 48 48 48 48 48 48 48 48 48 48 48
      48 48 48 0 0 0 0 0 0 0 0 0 0 0 0 0 0 0 0 0 0 0 0 0 0 0 0 0 0 0 48 48 48
      48 48 48 0 0 0 0 0 0 0 0 0 0 0 0 0 0 0 0 0 0 0 0 0 0 0 0 0 0 0 48 48 48
      48 48 48 0 0 0 0 0 0 0 0 0 0 0 0 0 0 0 0 0 0 0 0 0 0 0 0 0 0 0 48 48 48
      48 48 48 0 0 0 0 0 0 0 0 0 0 0 0 0 0 0 0 0 0 0 0 0 0 0 0 0 0 0 48 48 48
      48 48 48 0 0 0 0 0 0 0 0 0 0 0 0 0 0 0 0 0 0 0 0 0 0 0 0 0 0 0 48 48 48
      48 48 48 0 0 0 0 0 0 0 0 0 0 0 0 0 0 0 0 0 0 0 0 0 0 0 0 0 0 0 48 48 48
      48 48 48 0 0 0 0 0 0 0 0 0 0 0 0 0 0 0 0 0 0 0 0 0 0 0 0 0 0 0 48 48 48
      48 48 48 0 0 0 0 0 0 0 0 0 0 0 0 0 0 0 0 0 0 0 0 0 0 0 0 0 0 0 48 48 48
      48 48 48 0 0 0 0 0 0 0 0 0 0 0 0 0 0 0 0 0 0 0 0 0 0 0 0 0 0 0 48 48 48
      48 48 48 0 0 0 0 0 0 0 0 0 0 0 0 0 0 0 0 0 0 0 0 0 0 0 0 0 0 0 48 48 48
      48 48 48 0 0 0 0 0 0 0 0 0 0 0 0 0 0 0 0 0 0 0 0 0 0 0 0 0 0 0 48 48 48
      48 48 48 0 0 0 0 0 0 0 0 0 0 0 0 0 0 0 0 0 0 0 0 0 0 0 0 0 0 0 48 48 48
      48 48 48 0 0 0 0 0 0 0 0 0 0 0 0 0 0 0 0 0 0 0 0 0 0 0 0 0 0 0 48 48 48
      48 48 48 0 0 0 0 0 0 0 0 0 0 0 0 0 0 0 0 0 0 0 0 0 0 0 0 0 0 0 48 48 48
      48 48 48 0 0 0 0 0 0 0 0 0 0 0 0 0 0 0 0 0 0 0 0 0 0 0 0 0 0 0 48 48 48
      48 48 48 0 0 0 0 0 0 0 0 0 0 0 0 0 0 0 0 0 0 0 0 0 0 0 0 0 0 0 48 48 48
      48 48 48 0 0 0 0 0 0 0 0 0 0 0 0 0 0 0 0 0 0 0 0 0 0 0 0 0 0 0 48 48 48
      48 48 48 0 0 0 0 0 0 0 0 0 0 0 0 0 0 0 0 0 0 0 0 0 0 0 0 0 0 0 48 48 48
      48 48 48 0 0 0 0 0 0 0 0 0 0 0 0 0 0 0 0 0 0 0 0 0 0 0 0 0 0 0 48 48 48
      48 48 48 0 0 0 0 0 0 0 0 0 0 0 0 0 0 0 0 0 0 0 0 0 0 0 0 0 0 0 48 48 48
      48 48 48 2155 2156 2164 2156 2157 0 0 0 2155 2156 2164 2156 2156 2156 2156 2156 2164 2156 2157 0 0 0 2155 2156 2164 2156 2157 48 48 48
      48 48 48 0 0 2162 0 0 0 0 0 0 0 2162 0 0 0 0 0 2162 0 0 0 0 0 0 0 2162 0 0 48 48 48
      48 48 48 0 0 2162 0 0 0 0 0 0 0 2162 0 0 0 0 0 2162 0 0 0 0 0 0 0 2162 0 0 48 48 48
      48 48 48 0 0 2162 0 0 0 0 0 0 0 2162 0 0 0 0 0 2162 0 0 0 0 0 0 0 2162 0 0 48 48 48
      48 48 48 48 48 48 48 48 48 48 48 48 48 48 48 48 48 48 48 48 48 48 48 48 48 48 48 48 48 48 48 48 48
      48 48 48 48 48 48 48 48 48 48 48 48 48 48 48 48 48 48 48 48 48 48 48 48 48 48 48 48 48 48 48 48 48
      48 48 48 48 48 48 48 48 48 48 48 48 48 48 48 48 48 48 48 48 48 48 48 48 48 48 48 48 48 48 48 48 48
      )
    )
    (tilemap
      (solid #f)
      (z-pos -100)
      (name "Background")
      (width 33)
      (height 30)
      (tiles
      0 0 0 0 0 0 0 0 0 0 0 0 0 0 0 0 0 0 0 0 0 0 0 0 0 0 0 0 0 0 0 0 0
      0 0 0 0 0 0 0 0 0 0 0 0 0 0 0 0 0 0 0 0 0 0 0 0 0 0 0 0 0 0 0 0 0
      0 0 0 0 0 0 0 0 0 0 0 0 0 0 0 0 0 0 0 0 0 0 0 0 0 0 0 0 0 0 0 0 0
      0 0 0 0 0 0 0 0 0 0 0 0 0 0 0 0 0 0 0 0 0 0 0 0 0 0 0 0 0 0 0 0 0
      0 0 0 0 0 0 0 0 0 0 0 0 0 0 0 0 0 0 0 0 0 0 0 0 0 0 0 0 0 0 0 0 0
      0 0 0 0 0 0 0 0 0 0 0 0 0 0 0 0 0 0 0 0 0 0 0 0 0 0 0 0 0 0 0 0 0
      0 0 0 0 0 0 0 0 0 0 0 0 0 0 0 0 0 0 0 0 0 0 0 0 0 0 0 0 0 0 0 0 0
      0 0 0 0 0 0 0 0 0 0 0 0 0 0 0 0 0 0 0 0 0 0 0 0 0 0 0 0 0 0 0 0 0
      0 0 0 0 0 0 0 0 0 0 0 0 0 0 0 0 0 0 0 0 0 0 0 0 0 0 0 0 0 0 0 0 0
      0 0 0 0 0 0 0 0 0 0 0 0 0 0 0 0 0 0 0 0 0 0 0 0 0 0 0 0 0 0 0 0 0
      0 0 0 0 0 0 0 0 0 0 0 0 0 0 0 0 0 0 0 0 0 0 0 0 0 0 0 0 0 0 0 0 0
      0 0 0 0 0 0 0 0 0 0 0 0 0 0 0 0 0 0 0 0 0 0 0 0 0 0 0 0 0 0 0 0 0
      0 0 0 0 0 0 0 0 0 0 0 0 0 0 0 0 0 0 0 0 0 0 0 0 0 0 0 0 0 0 0 0 0
      0 0 0 0 0 0 0 0 0 0 0 0 0 0 0 0 0 0 0 0 0 0 0 0 0 0 0 0 0 0 0 0 0
      0 0 0 0 0 0 0 0 0 0 0 0 0 0 0 0 0 0 0 0 0 0 0 0 0 0 0 0 0 0 0 0 0
      0 0 0 0 0 0 0 0 0 0 0 0 0 0 0 0 0 0 0 0 0 0 0 0 0 0 0 0 0 0 0 0 0
      0 0 0 0 0 0 0 0 0 0 0 0 0 0 0 0 0 0 0 0 0 0 0 0 0 0 0 0 0 0 0 0 0
      0 0 0 0 0 0 0 0 0 0 0 0 0 0 0 0 0 0 0 0 0 0 0 0 0 0 0 0 0 0 0 0 0
      0 0 0 0 0 0 0 0 0 0 0 0 0 0 0 0 0 0 0 0 0 0 0 0 0 0 0 0 0 0 0 0 0
      0 0 0 0 0 0 0 0 0 0 0 0 0 0 0 0 0 0 0 0 0 0 0 0 0 0 0 0 0 0 0 0 0
      0 0 0 0 0 0 0 0 0 0 0 0 0 0 0 0 0 0 0 0 0 0 0 0 0 0 0 0 0 0 0 0 0
      0 0 0 0 0 0 0 0 0 0 0 0 0 0 0 0 0 0 0 0 0 0 0 0 0 0 0 0 0 0 0 0 0
      0 0 0 0 0 0 0 0 0 0 0 0 0 0 0 0 0 0 0 0 0 0 0 0 0 0 0 0 0 0 0 0 0
      0 0 0 2171 2172 2171 2172 2171 2172 2171 2172 2171 2172 2171 2172 2171 2172 2171 2172 2171 2172 2171 2172 2171 2172 2171 2172 2171 2172 2171 0 0 0
      0 0 0 2175 2176 2175 2176 2175 2176 2175 2176 2175 2176 2175 2176 2175 2176 2175 2176 2175 2176 2175 2176 2175 2176 2175 2176 2175 2176 2175 0 0 0
      0 0 0 2171 2172 2171 2172 2171 2172 2171 2172 2171 2172 2171 2172 2171 2172 2171 2172 2171 2172 2171 2172 2171 2172 2171 2172 2171 2172 2171 0 0 0
      0 0 0 2175 2176 2175 2176 2175 2176 2175 2176 2175 2176 2175 2176 2175 2176 2175 2176 2175 2176 2175 2176 2175 2176 2175 2176 2175 2176 2175 0 0 0
      0 0 0 0 0 0 0 0 0 0 0 0 0 0 0 0 0 0 0 0 0 0 0 0 0 0 0 0 0 0 0 0 0
      0 0 0 0 0 0 0 0 0 0 0 0 0 0 0 0 0 0 0 0 0 0 0 0 0 0 0 0 0 0 0 0 0
      0 0 0 0 0 0 0 0 0 0 0 0 0 0 0 0 0 0 0 0 0 0 0 0 0 0 0 0 0 0 0 0 0
      )
    )
  )
  (tileset "images/mw_tiles.strf")
)
