(supertux-level
  (version 2)
  (name (_ "The Secret Bonus Room"))
  (author "manuel")
  (license "General Publishing License")
  (target-time 3)
  (sector
    (name "main")
    (ambient-light 1 1 1)
    (camera
      (mode "normal")
    )
    (powerup
      (sprite "images/powerups/iceflower/iceflower.sprite")
      (x 768)
      (y 320)
    )
    (powerup
      (sprite "images/powerups/egg/egg.sprite")
      (x 864)
      (y 448)
    )
    (powerup
      (sprite "images/powerups/fireflower/fireflower.sprite")
      (x 960)
      (y 320)
    )
    (powerup
      (sprite "images/powerups/1up/1up.sprite")
      (x 864)
      (y 192)
    )
    (scripttrigger
      (script "jump <- true")
      (button #f)
      (width 860)
      (height 64)
      (x 448)
      (y 784)
    )
    (scripttrigger
      (script "if(!(\"jump\" in this)){
got_achievement(\"secretbonus\")
}")
      (button #f)
      (width 32)
      (height 128)
      (x 128)
      (y 800)
    )
    (scripttrigger
      (script "if(!(\"jump\" in this)){
got_achievement(\"secretbonus\")
}")
      (button #f)
      (width 32)
      (height 128)
      (x 1600)
      (y 800)
    )
    (sequencetrigger
      (sequence "endsequence")
      (width 32)
      (height 124)
      (x 1312)
      (y 800)
    )
    (sequencetrigger
      (sequence "endsequence")
      (width 32)
      (height 124)
      (x 416)
      (y 800)
    )
    (spawnpoint
      (name "main")
      (x 864)
      (y 896)
    )
    (tilemap
      (solid #f)
      (z-pos -100)
      (name "Background")
      (width 55)
      (height 35)
      (tiles
      3440 3440 3440 3440 3440 3440 3440 3440 3440 3440 3440 3440 3440 3440 3440 3440 3440 3440 3440 3440 3440 3440 3440 3440 3440 3440 3440 3440 3440 3440 3440 3440 3440 3440 3440 3440 3440 3440 3440 3440 3440 3440 3440 3440 3440 3440 3440 3440 3440 3440 3440 3440 3440 3440 3440
      3440 3440 3440 3440 3440 3440 3440 3440 3440 3440 3440 3440 3440 3440 3440 3440 3440 3440 3440 3440 3440 3440 3440 3440 3440 3440 3440 3440 3440 3440 3440 3440 3440 3440 3440 3440 3440 3440 3440 3440 3440 3440 3440 3440 3440 3440 3440 3440 3440 3440 3440 3440 3440 3440 3440
      3440 3440 3440 3440 3440 3440 3440 3440 3440 3440 3440 3440 3440 3440 3440 3440 3440 3440 3440 3440 3440 3440 3440 3440 3440 3440 3440 3440 3440 3440 3440 3440 3440 3440 3440 3440 3440 3440 3440 3440 3440 3440 3440 3440 3440 3440 3440 3440 3440 3440 3440 3440 3440 3440 3440
      3440 3440 3440 3440 3440 3440 3440 3440 3440 3440 3440 3440 3440 3440 3440 3440 3440 3440 3440 3440 3440 3440 3440 3440 3440 3440 3440 3440 3440 3440 3440 3440 3440 3440 3440 3440 3440 3440 3440 3440 3440 3440 3440 3440 3440 3440 3440 3440 3440 3440 3440 3440 3440 3440 3440
      3440 3440 3440 3440 3440 3440 3440 3440 3440 3440 3440 3440 3440 3440 3440 3440 3440 3440 3440 3440 3440 3440 3440 3440 3440 3440 3440 3440 3440 3440 3440 3440 3440 3440 3440 3440 3440 3440 3440 3440 3440 3440 3440 3440 3440 3440 3440 3440 3440 3440 3440 3440 3440 3440 3440
      3440 3440 3440 3440 3440 3440 3440 3440 3440 3440 3440 3440 3440 3440 3440 3440 3440 3440 3440 3440 3440 3440 3440 3440 3440 3440 3440 3440 3440 3440 3440 3440 3440 3440 3440 3440 3440 3440 3440 3440 3440 3440 3440 3440 3440 3440 3440 3440 3440 3440 3440 3440 3440 3440 3440
      3440 3440 3440 3440 3440 3440 3440 3440 3440 3440 3440 3440 3440 3440 3440 3440 3440 3440 3440 3440 3440 3440 3440 3440 3440 3440 3440 3440 3440 3440 3440 3440 3440 3440 3440 3440 3440 3440 3440 3440 3440 3440 3440 3440 3440 3440 3440 3440 3440 3440 3440 3440 3440 3440 3440
      3440 3440 3440 3440 3440 3440 3440 3440 3440 3440 3440 3440 3440 3440 3440 3440 3440 3440 3440 3440 3440 3440 3440 3440 3440 3440 3440 3440 3440 3440 3440 3440 3440 3440 3440 3440 3440 3440 3440 3440 3440 3440 3440 3440 3440 3440 3440 3440 3440 3440 3440 3440 3440 3440 3440
      3440 3440 3440 3440 3440 3440 3440 3440 3440 3440 3440 3440 3440 3440 3440 3440 3440 3440 3440 3440 3440 3440 3440 3440 3440 3440 3440 3440 3440 3440 3440 3440 3440 3440 3440 3440 3440 3440 3440 3440 3440 3440 3440 3440 3440 3440 3440 3440 3440 3440 3440 3440 3440 3440 3440
      3440 3440 3440 3440 3440 3440 3440 3440 3440 3440 3440 3440 3440 3440 3440 3440 3440 3440 3440 3440 3440 3440 3440 3440 3440 3440 3440 3440 3440 3440 3440 3440 3440 3440 3440 3440 3440 3440 3440 3440 3440 3440 3440 3440 3440 3440 3440 3440 3440 3440 3440 3440 3440 3440 3440
      3440 3440 3440 3440 3440 3440 3440 3440 3440 3440 3440 3440 3440 3440 3440 3440 3440 3440 3440 3440 3440 3440 3440 3440 3440 3440 3440 3440 3440 3440 3440 3440 3440 3440 3440 3440 3440 3440 3440 3440 3440 3440 3440 3440 3440 3440 3440 3440 3440 3440 3440 3440 3440 3440 3440
      3440 3440 3440 3440 3440 3440 3440 3440 3440 3440 3440 3440 3440 3440 3440 3440 3440 3440 3440 3440 3440 3440 3440 3440 3440 3440 3440 3440 3440 3440 3440 3440 3440 3440 3440 3440 3440 3440 3440 3440 3440 3440 3440 3440 3440 3440 3440 3440 3440 3440 3440 3440 3440 3440 3440
      3440 3440 3440 3440 3440 3440 3440 3440 3440 3440 3440 3440 3440 3440 3440 3440 3440 3440 3440 3440 3440 3440 3440 3440 3440 3440 3440 3440 3440 3440 3440 3440 3440 3440 3440 3440 3440 3440 3440 3440 3440 3440 3440 3440 3440 3440 3440 3440 3440 3440 3440 3440 3440 3440 3440
      3440 3440 3440 3440 3440 3440 3440 3440 3440 3440 3440 3440 3440 3440 3440 3440 3440 3440 3440 3440 3440 3440 3440 3440 3440 3440 3440 3440 3440 3440 3440 3440 3440 3440 3440 3440 3440 3440 3440 3440 3440 3440 3440 3440 3440 3440 3440 3440 3440 3440 3440 3440 3440 3440 3440
      3440 3440 3440 3440 3440 3440 3440 3440 3440 3440 3440 3440 3440 3440 3440 3440 3440 3440 3440 3440 3440 3440 3440 3440 3440 3440 3440 3440 3440 3440 3440 3440 3440 3440 3440 3440 3440 3440 3440 3440 3440 3440 3440 3440 3440 3440 3440 3440 3440 3440 3440 3440 3440 3440 3440
      3440 3440 3440 3440 3440 3440 3440 3440 3440 3440 3440 3440 3440 3440 3440 3440 3440 3440 3440 3440 3440 3440 3440 3440 3440 3440 3440 3440 3440 3440 3440 3440 3440 3440 3440 3440 3440 3440 3440 3440 3440 3440 3440 3440 3440 3440 3440 3440 3440 3440 3440 3440 3440 3440 3440
      3440 3440 3440 3440 3440 3440 3440 3440 3440 3440 3440 3440 3440 3440 3440 3440 3440 3440 3440 3440 3440 3440 3440 3440 3440 3440 3440 3440 3440 3440 3440 3440 3440 3440 3440 3440 3440 3440 3440 3440 3440 3440 3440 3440 3440 3440 3440 3440 3440 3440 3440 3440 3440 3440 3440
      3440 3440 3440 3440 3440 3440 3440 3440 3440 3440 3440 3440 3440 3440 3440 3440 3440 3440 3440 3440 3440 3440 3440 3440 3440 3440 3440 3440 3440 3440 3440 3440 3440 3440 3440 3440 3440 3440 3440 3440 3440 3440 3440 3440 3440 3440 3440 3440 3440 3440 3440 3440 3440 3440 3440
      3440 3440 3440 3440 3440 3440 3440 3440 3440 3440 3440 3440 3440 3440 3440 3440 3440 3440 3440 3440 3440 3440 3440 3440 3440 3440 3440 3440 3440 3440 3440 3440 3440 3440 3440 3440 3440 3440 3440 3440 3440 3440 3440 3440 3440 3440 3440 3440 3440 3440 3440 3440 3440 3440 3440
      3440 3440 3440 3440 3440 3440 3440 3440 3440 3440 3440 3440 3440 3440 3440 3440 3440 3440 3440 3440 3440 3440 3440 3440 3440 3440 3440 3440 3440 3440 3440 3440 3440 3440 3440 3440 3440 3440 3440 3440 3440 3440 3440 3440 3440 3440 3440 3440 3440 3440 3440 3440 3440 3440 3440
      3440 3440 3440 3440 3440 3440 3440 3440 3440 3440 3440 3440 3440 3440 3440 3440 3440 3440 3440 3440 3440 3440 3440 3440 3440 3440 3440 3440 3440 3440 3440 3440 3440 3440 3440 3440 3440 3440 3440 3440 3440 3440 3440 3440 3440 3440 3440 3440 3440 3440 3440 3440 3440 3440 3440
      3440 3440 3440 3440 3440 3440 3440 3440 3440 3440 3440 3440 3440 3440 3440 3440 3440 3440 3440 3440 3440 3440 3440 3440 3440 3440 3440 3440 3440 3440 3440 3440 3440 3440 3440 3440 3440 3440 3440 3440 3440 3440 3440 3440 3440 3440 3440 3440 3440 3440 3440 3440 3440 3440 3440
      3440 3440 3440 3440 3440 3440 3440 3440 3440 3440 3440 3440 3440 3440 3440 3440 3440 3440 3440 3440 3440 3440 3440 3440 3440 3440 3440 3440 3440 3440 3440 3440 3440 3440 3440 3440 3440 3440 3440 3440 3440 3440 3440 3440 3440 3440 3440 3440 3440 3440 3440 3440 3440 3440 3440
      3440 3440 3440 3440 3440 3440 3440 3440 3440 3440 3440 3440 3440 3440 3440 3440 3440 3440 3440 3440 3440 3440 3440 3440 3440 3440 3440 3440 3440 3440 3440 3440 3440 3440 3440 3440 3440 3440 3440 3440 3440 3440 3440 3440 3440 3440 3440 3440 3440 3440 3440 3440 3440 3440 3440
      3440 3440 3440 3440 3440 3440 3440 3440 3440 3440 3440 3440 3440 3440 3440 3440 3440 3440 3440 3440 3440 3440 3440 3440 3440 3440 3440 3440 3440 3440 3440 3440 3440 3440 3440 3440 3440 3440 3440 3440 3440 3440 3440 3440 3440 3440 3440 3440 3440 3440 3440 3440 3440 3440 3440
      3440 3440 3440 3440 3440 3440 3440 3440 3440 3440 3440 3440 3440 3440 3440 3440 3440 3440 3440 3440 3440 3440 3440 3440 3440 3440 3440 3440 3440 3440 3440 3440 3440 3440 3440 3440 3440 3440 3440 3440 3440 3440 3440 3440 3440 3440 3440 3440 3440 3440 3440 3440 3440 3440 3440
      3440 3440 3440 3440 3440 3440 3440 3440 3440 3440 3440 3440 3440 3440 3440 3440 3440 3440 3440 3440 3440 3440 3440 3440 3440 3440 3440 3440 3440 3440 3440 3440 3440 3440 3440 3440 3440 3440 3440 3440 3440 3440 3440 3440 3440 3440 3440 3440 3440 3440 3440 3440 3440 3440 3440
      3440 3440 3440 3440 3440 3440 3440 3440 3440 3440 3440 3440 3440 3440 3440 3440 3440 3440 3440 3440 3440 3440 3440 3440 3440 3440 3440 3440 3440 3440 3440 3440 3440 3440 3440 3440 3440 3440 3440 3440 3440 3440 3440 3440 3440 3440 3440 3440 3440 3440 3440 3440 3440 3440 3440
      3440 3440 3440 3440 3440 3440 3440 3440 3440 3440 3440 3440 3440 3440 3440 3440 3440 3440 3440 3440 3440 3440 3440 3440 3440 3440 3440 3440 3440 3440 3440 3440 3440 3440 3440 3440 3440 3440 3440 3440 3440 3440 3440 3440 3440 3440 3440 3440 3440 3440 3440 3440 3440 3440 3440
      3440 3440 3440 3440 3440 3440 3440 3440 3440 3440 3440 3440 3440 3440 3440 3440 3440 3440 3440 3440 3440 3440 3440 3440 3440 3440 3440 3440 3440 3440 3440 3440 3440 3440 3440 3440 3440 3440 3440 3440 3440 3440 3440 3440 3440 3440 3440 3440 3440 3440 3440 3440 3440 3440 3440
      3440 3440 3440 3440 3440 3440 3440 3440 3440 3440 3440 3440 3440 3440 3440 3440 3440 3440 3440 3440 3440 3440 3440 3440 3440 3440 3440 3440 3440 3440 3440 3440 3440 3440 3440 3440 3440 3440 3440 3440 3440 3440 3440 3440 3440 3440 3440 3440 3440 3440 3440 3440 3440 3440 3440
      3440 3440 3440 3440 3440 3440 3440 3440 3440 3440 3440 3440 3440 3440 3440 3440 3440 3440 3440 3440 3440 3440 3440 3440 3440 3440 3440 3440 3440 3440 3440 3440 3440 3440 3440 3440 3440 3440 3440 3440 3440 3440 3440 3440 3440 3440 3440 3440 3440 3440 3440 3440 3440 3440 3440
      3440 3440 3440 3440 3440 3440 3440 3440 3440 3440 3440 3440 3440 3440 3440 3440 3440 3440 3440 3440 3440 3440 3440 3440 3440 3440 3440 3440 3440 3440 3440 3440 3440 3440 3440 3440 3440 3440 3440 3440 3440 3440 3440 3440 3440 3440 3440 3440 3440 3440 3440 3440 3440 3440 3440
      3440 3440 3440 3440 3440 3440 3440 3440 3440 3440 3440 3440 3440 3440 3440 3440 3440 3440 3440 3440 3440 3440 3440 3440 3440 3440 3440 3440 3440 3440 3440 3440 3440 3440 3440 3440 3440 3440 3440 3440 3440 3440 3440 3440 3440 3440 3440 3440 3440 3440 3440 3440 3440 3440 3440
      3440 3440 3440 3440 3440 3440 3440 3440 3440 3440 3440 3440 3440 3440 3440 3440 3440 3440 3440 3440 3440 3440 3440 3440 3440 3440 3440 3440 3440 3440 3440 3440 3440 3440 3440 3440 3440 3440 3440 3440 3440 3440 3440 3440 3440 3440 3440 3440 3440 3440 3440 3440 3440 3440 3440
      )
    )
    (tilemap
      (solid #t)
      (z-pos 75)
      (name "Interactive")
      (width 55)
      (height 35)
      (tiles
      3300 3300 3300 3300 3300 3300 3300 3300 3300 3300 3300 3300 3300 3300 3300 3300 3300 3300 3300 3300 3300 3300 3300 3300 3300 3300 3300 3300 3300 3300 3300 3300 3300 3300 3300 3300 3300 3300 3300 3300 3300 3300 3300 3300 3300 3300 3300 3300 3300 3300 3300 3300 3300 3300 3300
      3300 3300 3300 3300 3300 3300 3300 3300 3300 3300 3300 3300 3300 3300 3300 3300 3300 3300 3300 3300 3300 3300 3300 3300 3300 3300 3300 3300 3300 3300 3300 3300 3300 3300 3300 3300 3300 3300 3300 3300 3300 3300 3300 3300 3300 3300 3300 3300 3300 3300 3300 3300 3300 3300 3300
      3300 3300 3300 3300 3300 3300 3300 3300 3300 3300 3300 3300 3300 3300 3300 3300 3300 3300 3300 3300 3300 3300 3300 3300 3300 3300 3300 3300 3300 3300 3300 3300 3300 3300 3300 3300 3300 3300 3300 3300 3300 3300 3300 3300 3300 3300 3300 3300 3300 3300 3300 3300 3300 3300 3300
      3300 3300 3300 3300 3300 3300 3300 3300 3300 3300 3300 3300 3300 3300 3300 3300 3300 3300 3300 3300 3300 3300 3300 3300 3300 3300 3300 3300 3300 3300 3300 3300 3300 3300 3300 3300 3300 3300 3300 3300 3300 3300 3300 3300 3300 3300 3300 3300 3300 3300 3300 3300 3300 3300 3300
      3300 3300 3300 3300 3300 3300 3300 3300 3300 3300 3300 3300 3300 3307 3304 3304 3304 3304 3304 3304 3304 3304 3304 3304 3304 3304 3304 3304 3304 3304 3304 3304 3304 3304 3304 3304 3304 3304 3304 3304 3304 3310 3300 3300 3300 3300 3300 3300 3300 3300 3300 3300 3300 3300 3300
      3300 3300 3300 3300 3300 3300 3300 3300 3300 3300 3300 3300 3300 3301 0 0 0 0 0 0 0 0 0 0 0 0 0 0 0 0 0 0 0 0 0 0 0 0 0 0 0 3299 3300 3300 3300 3300 3300 3300 3300 3300 3300 3300 3300 3300 3300
      3300 3300 3300 3300 3300 3300 3300 3300 3300 3300 3300 3300 3300 3301 0 0 0 0 0 0 0 0 0 0 0 0 0 0 0 0 0 0 0 0 0 0 0 0 0 0 0 3299 3300 3300 3300 3300 3300 3300 3300 3300 3300 3300 3300 3300 3300
      3300 3300 3300 3300 3300 3300 3300 3300 3300 3300 3300 3300 3300 3301 0 0 0 0 0 0 0 0 0 0 0 0 3410 3502 3411 0 0 0 0 0 0 0 0 0 0 0 0 3299 3300 3300 3300 3300 3300 3300 3300 3300 3300 3300 3300 3300 3300
      3300 3300 3300 3300 3300 3300 3300 3300 3300 3300 3300 3300 3300 3301 0 0 0 0 0 0 0 0 0 0 0 0 3500 3379 3501 0 0 0 0 0 0 0 0 0 0 0 0 3299 3300 3300 3300 3300 3300 3300 3300 3300 3300 3300 3300 3300 3300
      3300 3300 3300 3300 3300 3300 3300 3300 3300 3300 3300 3300 3300 3301 0 0 0 0 0 0 0 0 0 0 0 0 3413 3503 3412 0 0 0 0 0 0 0 0 0 0 0 0 3299 3300 3300 3300 3300 3300 3300 3300 3300 3300 3300 3300 3300 3300
      3300 3300 3300 3300 3300 3300 3300 3300 3300 3300 3300 3300 3300 3301 0 0 0 0 0 0 0 0 0 0 0 0 0 0 0 0 0 0 0 0 0 0 0 0 0 0 0 3299 3300 3300 3300 3300 3300 3300 3300 3300 3300 3300 3300 3300 3300
      3300 3300 3300 3300 3300 3300 3300 3300 3300 3300 3300 3300 3300 3301 0 0 0 0 0 0 0 0 0 3410 3502 3411 0 0 0 3410 3502 3411 0 0 0 0 0 0 0 0 0 3299 3300 3300 3300 3300 3300 3300 3300 3300 3300 3300 3300 3300 3300
      3300 3300 3300 3300 3300 3300 3300 3300 3300 3300 3300 3300 3300 3301 0 0 0 0 0 0 0 0 0 3500 3379 3501 0 0 0 3500 3379 3501 0 0 0 0 0 0 0 0 0 3299 3300 3300 3300 3300 3300 3300 3300 3300 3300 3300 3300 3300 3300
      3300 3300 3300 3300 3300 3300 3300 3300 3300 3300 3300 3300 3300 3301 0 0 0 0 0 0 0 0 0 3413 3503 3412 0 0 0 3413 3503 3412 0 0 0 0 0 0 0 0 0 3299 3300 3300 3300 3300 3300 3300 3300 3300 3300 3300 3300 3300 3300
      3300 3300 3300 3300 3300 3300 3300 3300 3300 3300 3300 3300 3300 3301 0 3472 3473 0 0 0 0 44 0 0 0 0 0 0 0 0 0 0 0 44 0 0 0 0 0 0 0 3299 3300 3300 3300 3300 3300 3300 3300 3300 3300 3300 3300 3300 3300
      3300 3300 3300 3300 3300 3300 3300 3300 3300 3300 3300 3300 3300 3301 0 3479 3480 0 0 0 3410 3502 3411 0 0 0 3410 3502 3411 0 0 0 3410 3502 3411 0 0 0 3452 3485 0 3299 3300 3300 3300 3300 3300 3300 3300 3300 3300 3300 3300 3300 3300
      3300 3300 3300 3300 3300 3300 3300 3300 3300 3300 3300 3300 3300 3308 3292 3486 3487 3293 0 0 3500 3379 3501 0 0 0 3500 3379 3501 0 0 0 3500 3379 3501 0 0 3291 3477 3478 3292 3311 3300 3300 3300 3300 3300 3300 3300 3300 3300 3300 3300 3300 3300
      3300 3300 3300 3300 3300 3300 3300 3300 3300 3300 3300 3300 3300 3309 3296 3296 3296 3297 0 0 3413 3503 3412 0 0 0 3413 3503 3412 0 0 0 3413 3503 3412 0 0 3295 3296 3296 3296 3312 3300 3300 3300 3300 3300 3300 3300 3300 3300 3300 3300 3300 3300
      3300 3300 3300 3300 3300 3300 3300 3300 3300 3300 3300 3300 3300 3300 3307 3304 3304 3305 0 0 0 0 0 0 44 0 0 0 0 0 44 0 0 0 0 0 0 3303 3304 3304 3310 3300 3300 3300 3300 3300 3300 3300 3300 3300 3300 3300 3300 3300 3300
      3300 3300 3300 3300 3300 3300 3300 3300 3300 3300 3300 3300 3300 3307 3305 0 0 0 0 0 0 0 0 3410 3502 3411 0 0 0 3410 3502 3411 0 0 0 0 0 0 0 0 3303 3310 3300 3300 3300 3300 3300 3300 3300 3300 3300 3300 3300 3300 3300
      3300 3300 3300 3300 3300 3300 3300 3300 3300 3300 3300 3300 3300 3301 0 0 0 0 0 0 0 0 0 3500 3379 3501 0 0 0 3500 3379 3501 0 0 0 0 0 0 0 0 0 3299 3300 3300 3300 3300 3300 3300 3300 3300 3300 3300 3300 3300 3300
      3300 3300 3300 3300 3300 3300 3300 3300 3300 3300 3300 3300 3300 3301 0 0 0 0 0 0 0 0 0 3413 3503 3412 0 0 0 3413 3503 3412 0 0 0 0 0 0 0 0 0 3299 3300 3300 3300 3300 3300 3300 3300 3300 3300 3300 3300 3300 3300
      3300 3300 3300 3300 3300 3300 3300 3300 3300 3300 3300 3300 3300 3301 0 0 0 0 0 0 0 0 0 0 0 0 0 44 0 0 0 0 0 0 0 0 0 0 0 0 0 3299 3300 3300 3300 3300 3300 3300 3300 3300 3300 3300 3300 3300 3300
      3300 3300 3300 3300 3300 3300 3300 3300 3300 3300 3300 3300 3300 3301 0 0 0 0 0 0 0 0 0 0 0 0 3410 3502 3411 0 0 0 0 0 0 0 0 0 0 0 0 3299 3300 3300 3300 3300 3300 3300 3300 3300 3300 3300 3300 3300 3300
      3300 3300 3300 3300 3300 3300 3300 3300 3300 3300 3300 3300 3300 3301 0 0 0 0 0 0 0 0 0 0 0 0 3500 3379 3501 0 0 0 0 0 0 0 0 0 0 0 0 3299 3300 3300 3300 3300 3300 3300 3300 3300 3300 3300 3300 3300 3300
      3300 3300 3300 3307 3304 3304 3304 3304 3304 3304 3304 3304 3304 3305 0 0 0 0 0 0 0 0 0 0 0 0 3413 3503 3412 0 0 0 0 0 0 0 0 0 0 0 0 3303 3304 3304 3304 3304 3304 3304 3304 3304 3304 3310 3300 3300 3300
      3300 3300 3300 3301 0 0 0 0 0 0 0 0 0 0 0 0 0 0 0 0 0 0 0 0 0 0 0 0 0 0 0 0 0 0 0 0 0 0 0 0 0 0 0 0 0 0 0 0 0 0 0 3299 3300 3300 3300
      3300 3300 3300 3301 0 0 0 0 0 0 0 0 0 0 0 0 0 0 0 0 0 0 0 0 0 0 0 0 0 0 0 0 0 0 0 0 0 0 0 0 0 0 0 0 0 0 0 0 0 0 0 3299 3300 3300 3300
      3300 3300 3300 3308 3292 3292 3292 3292 3292 3292 3292 3292 3292 3292 3292 3292 3292 3292 3292 3292 3292 3292 3292 3292 3292 3292 3292 3292 3292 3292 3292 3292 3292 3292 3292 3292 3292 3292 3292 3292 3292 3292 3292 3292 3292 3292 3292 3292 3292 3292 3292 3311 3300 3300 3300
      3300 3300 3300 3309 3296 3296 3296 3296 3296 3296 3296 3296 3296 3296 3296 3296 3296 3296 3296 3296 3296 3296 3296 3296 3296 3296 3296 3296 3296 3296 3296 3296 3296 3296 3296 3296 3296 3296 3296 3296 3296 3296 3296 3296 3296 3296 3296 3296 3296 3296 3296 3312 3300 3300 3300
      3300 3300 3300 3300 3300 3300 3300 3300 3300 3300 3300 3300 3300 3300 3300 3300 3300 3300 3300 3300 3300 3300 3300 3300 3300 3300 3300 3300 3300 3300 3300 3300 3300 3300 3300 3300 3300 3300 3300 3300 3300 3300 3300 3300 3300 3300 3300 3300 3300 3300 3300 3300 3300 3300 3300
      3300 3300 3300 3300 3300 3300 3300 3300 3300 3300 3300 3300 3300 3300 3300 3300 3300 3300 3300 3300 3300 3300 3300 3300 3300 3300 3300 3300 3300 3300 3300 3300 3300 3300 3300 3300 3300 3300 3300 3300 3300 3300 3300 3300 3300 3300 3300 3300 3300 3300 3300 3300 3300 3300 3300
      3300 3300 3300 3300 3300 3300 3300 3300 3300 3300 3300 3300 3300 3300 3300 3300 3300 3300 3300 3300 3300 3300 3300 3300 3300 3300 3300 3300 3300 3300 3300 3300 3300 3300 3300 3300 3300 3300 3300 3300 3300 3300 3300 3300 3300 3300 3300 3300 3300 3300 3300 3300 3300 3300 3300
      3300 3300 3300 3300 3300 3300 3300 3300 3300 3300 3300 3300 3300 3300 3300 3300 3300 3300 3300 3300 3300 3300 3300 3300 3300 3300 3300 3300 3300 3300 3300 3300 3300 3300 3300 3300 3300 3300 3300 3300 3300 3300 3300 3300 3300 3300 3300 3300 3300 3300 3300 3300 3300 3300 3300
      3300 3300 3300 3300 3300 3300 3300 3300 3300 3300 3300 3300 3300 3300 3300 3300 3300 3300 3300 3300 3300 3300 3300 3300 3300 3300 3300 3300 3300 3300 3300 3300 3300 3300 3300 3300 3300 3300 3300 3300 3300 3300 3300 3300 3300 3300 3300 3300 3300 3300 3300 3300 3300 3300 3300
      )
    )
    (tilemap
      (solid #f)
      (z-pos 100)
      (name "Foreground")
      (width 55)
      (height 35)
      (tiles
      0 0 0 0 0 0 0 0 0 0 0 0 0 0 0 0 0 0 0 0 0 0 0 0 0 0 0 0 0 0 0 0 0 0 0 0 0 0 0 0 0 0 0 0 0 0 0 0 0 0 0 0 0 0 0
      0 0 0 0 0 0 0 0 0 0 0 0 0 0 0 0 0 0 0 0 0 0 0 0 0 0 0 0 0 0 0 0 0 0 0 0 0 0 0 0 0 0 0 0 0 0 0 0 0 0 0 0 0 0 0
      0 0 0 0 0 0 0 0 0 0 0 0 0 0 0 0 0 0 0 0 0 0 0 0 0 0 0 0 0 0 0 0 0 0 0 0 0 0 0 0 0 0 0 0 0 0 0 0 0 0 0 0 0 0 0
      0 0 0 0 0 0 0 0 0 0 0 0 0 0 0 0 0 0 0 0 0 0 0 0 0 0 0 0 0 0 0 0 0 0 0 0 0 0 0 0 0 0 0 0 0 0 0 0 0 0 0 0 0 0 0
      0 0 0 0 0 0 0 0 0 0 0 0 0 0 0 0 0 0 0 0 0 0 0 0 0 0 0 0 0 0 0 0 0 0 0 0 0 0 0 0 0 0 0 0 0 0 0 0 0 0 0 0 0 0 0
      0 0 0 0 0 0 0 0 0 0 0 0 0 0 0 0 0 0 0 0 0 0 0 0 0 0 0 0 0 0 0 0 0 0 0 0 0 0 0 0 0 0 0 0 0 0 0 0 0 0 0 0 0 0 0
      0 0 0 0 0 0 0 0 0 0 0 0 0 0 0 0 0 0 0 0 0 0 0 0 0 0 0 0 0 0 0 0 0 0 0 0 0 0 0 0 0 0 0 0 0 0 0 0 0 0 0 0 0 0 0
      0 0 0 0 0 0 0 0 0 0 0 0 0 0 0 0 0 0 0 0 0 0 0 0 0 0 0 0 0 0 0 0 0 0 0 0 0 0 0 0 0 0 0 0 0 0 0 0 0 0 0 0 0 0 0
      0 0 0 0 0 0 0 0 0 0 0 0 0 0 0 0 0 0 0 0 0 0 0 0 0 0 0 0 0 0 0 0 0 0 0 0 0 0 0 0 0 0 0 0 0 0 0 0 0 0 0 0 0 0 0
      0 0 0 0 0 0 0 0 0 0 0 0 0 0 0 0 0 0 0 0 0 0 0 0 0 0 0 0 0 0 0 0 0 0 0 0 0 0 0 0 0 0 0 0 0 0 0 0 0 0 0 0 0 0 0
      0 0 0 0 0 0 0 0 0 0 0 0 0 0 0 0 0 0 0 0 0 0 0 0 0 0 0 0 0 0 0 0 0 0 0 0 0 0 0 0 0 0 0 0 0 0 0 0 0 0 0 0 0 0 0
      0 0 0 0 0 0 0 0 0 0 0 0 0 0 0 0 0 0 0 0 0 0 0 0 0 0 0 0 0 0 0 0 0 0 0 0 0 0 0 0 0 0 0 0 0 0 0 0 0 0 0 0 0 0 0
      0 0 0 0 0 0 0 0 0 0 0 0 0 0 0 0 0 0 0 0 0 0 0 0 0 0 0 0 0 0 0 0 0 0 0 0 0 0 0 0 0 0 0 0 0 0 0 0 0 0 0 0 0 0 0
      0 0 0 0 0 0 0 0 0 0 0 0 0 0 0 0 0 0 0 0 0 0 0 0 0 0 0 0 0 0 0 0 0 0 0 0 0 0 0 0 0 0 0 0 0 0 0 0 0 0 0 0 0 0 0
      0 0 0 0 0 0 0 0 0 0 0 0 0 0 0 0 0 0 0 0 0 0 0 0 0 0 0 0 0 0 0 0 0 0 0 0 0 0 0 0 0 0 0 0 0 0 0 0 0 0 0 0 0 0 0
      0 0 0 0 0 0 0 0 0 0 0 0 0 0 0 0 0 0 0 0 0 0 0 0 0 0 0 0 0 0 0 0 0 0 0 0 0 0 0 0 0 0 0 0 0 0 0 0 0 0 0 0 0 0 0
      0 0 0 0 0 0 0 0 0 0 0 0 0 0 0 3292 3292 0 0 0 0 0 0 0 0 0 0 0 0 0 0 0 0 0 0 0 0 0 3292 3292 0 0 0 0 0 0 0 0 0 0 0 0 0 0 0
      0 0 0 0 0 0 0 0 0 0 0 0 0 0 0 0 0 0 0 0 0 0 0 0 0 0 0 0 0 0 0 0 0 0 0 0 0 0 0 0 0 0 0 0 0 0 0 0 0 0 0 0 0 0 0
      0 0 0 0 0 0 0 0 0 0 0 0 0 0 0 0 0 0 0 0 0 0 0 0 0 0 0 0 0 0 0 0 0 0 0 0 0 0 0 0 0 0 0 0 0 0 0 0 0 0 0 0 0 0 0
      0 0 0 0 0 0 0 0 0 0 0 0 0 0 0 0 0 0 0 0 0 0 0 0 0 0 0 0 0 0 0 0 0 0 0 0 0 0 0 0 0 0 0 0 0 0 0 0 0 0 0 0 0 0 0
      0 0 0 0 0 0 0 0 0 0 0 0 0 0 0 0 0 0 0 0 0 0 0 0 0 0 0 0 0 0 0 0 0 0 0 0 0 0 0 0 0 0 0 0 0 0 0 0 0 0 0 0 0 0 0
      0 0 0 0 0 0 0 0 0 0 0 0 0 0 0 0 0 0 0 0 0 0 0 0 0 0 0 0 0 0 0 0 0 0 0 0 0 0 0 0 0 0 0 0 0 0 0 0 0 0 0 0 0 0 0
      0 0 0 0 0 0 0 0 0 0 0 0 0 0 0 0 0 0 0 0 0 0 0 0 0 0 0 0 0 0 0 0 0 0 0 0 0 0 0 0 0 0 0 0 0 0 0 0 0 0 0 0 0 0 0
      0 0 0 0 0 0 0 0 0 0 0 0 0 0 0 0 0 0 0 0 0 0 0 0 0 0 0 0 0 0 0 0 0 0 0 0 0 0 0 0 0 0 0 0 0 0 0 0 0 0 0 0 0 0 0
      0 0 0 0 0 0 0 0 0 0 0 0 0 0 0 0 0 0 0 0 0 0 0 0 0 0 0 0 0 0 0 0 0 0 0 0 0 0 0 0 0 0 0 0 0 0 0 0 0 0 0 0 0 0 0
      0 0 0 0 0 0 0 0 0 0 0 0 0 3481 0 0 0 0 0 0 0 0 0 0 0 0 0 0 0 0 0 0 0 0 0 0 0 0 0 0 0 3481 0 0 0 0 0 0 0 0 0 0 0 0 0
      0 0 0 0 0 0 0 0 0 0 0 0 0 3481 0 0 0 0 0 0 0 0 0 0 0 0 0 0 0 0 0 0 0 0 0 0 0 0 0 0 0 3481 0 0 0 0 0 0 0 0 0 0 0 0 0
      0 0 0 0 0 0 0 0 0 0 0 0 0 3481 0 0 0 0 0 0 0 0 0 0 0 0 0 0 0 0 0 0 0 0 0 0 0 0 0 0 0 3481 0 0 0 0 0 0 0 0 0 0 0 0 0
      0 0 0 0 0 0 0 0 0 0 0 0 0 3481 0 0 0 0 0 0 0 0 0 0 0 0 0 0 0 0 0 0 0 0 0 0 0 0 0 0 0 3481 0 0 0 0 0 0 0 0 0 0 0 0 0
      0 0 0 0 0 0 0 0 0 0 0 0 0 0 0 0 0 0 0 0 0 0 0 0 0 0 0 0 0 0 0 0 0 0 0 0 0 0 0 0 0 0 0 0 0 0 0 0 0 0 0 0 0 0 0
      0 0 0 0 0 0 0 0 0 0 0 0 0 0 0 0 0 0 0 0 0 0 0 0 0 0 0 0 0 0 0 0 0 0 0 0 0 0 0 0 0 0 0 0 0 0 0 0 0 0 0 0 0 0 0
      0 0 0 0 0 0 0 0 0 0 0 0 0 0 0 0 0 0 0 0 0 0 0 0 0 0 0 0 0 0 0 0 0 0 0 0 0 0 0 0 0 0 0 0 0 0 0 0 0 0 0 0 0 0 0
      0 0 0 0 0 0 0 0 0 0 0 0 0 0 0 0 0 0 0 0 0 0 0 0 0 0 0 0 0 0 0 0 0 0 0 0 0 0 0 0 0 0 0 0 0 0 0 0 0 0 0 0 0 0 0
      0 0 0 0 0 0 0 0 0 0 0 0 0 0 0 0 0 0 0 0 0 0 0 0 0 0 0 0 0 0 0 0 0 0 0 0 0 0 0 0 0 0 0 0 0 0 0 0 0 0 0 0 0 0 0
      0 0 0 0 0 0 0 0 0 0 0 0 0 0 0 0 0 0 0 0 0 0 0 0 0 0 0 0 0 0 0 0 0 0 0 0 0 0 0 0 0 0 0 0 0 0 0 0 0 0 0 0 0 0 0
      )
    )
  )
  (tileset "images/mw_tiles.strf")
)
